...........#..#...........
...........#..#...........
......##...####...##......
..##..##..........##..##..
..##..##..........##..##..
..##..##..##..##..##..##..
..##..##..######..##..##..
..##..##..######..##..##..
..##..##..##..##..##..##..
..##..##..........##..##..
..##..##..........##..##..
..........##..##..........
..........##..##..........
##..####..........####..##
##..####..........####..##
..........##..##..........
..........######..........
..##..##..######..##..##..
..##..##..##..##..##..##..
..##..##..##..##..##..##..
..##..##..##..##..##..##..
..##..##..........##..##..
..##..##..........##..##..
......##...####...##......
...........#..#...........
...........#..#...........